%%%%%%%%%%%%%%%%%%%%%%%%%%%%%%
%.                          P%
%%%%%%%%%%%%%%%%%%%%%%%%%%%%%%
