%%%%%%%%%%%%%%%%%%%%
%.%P          %    %
%%%% %% %% %% %% % %
%                % %
%%%%%%%%%%%%%%%%%% %
%.%................%
%%%%%%%%%%%%%%%%%%%%
